8 8
5 1 1 1 1 1 5 5
1 1 0 0 0 1 1 1
1 0 0 1 0 0 0 1
1 0 1 0 0 1 0 1
1 0 2 0 2 1 0 1
1 3 1 0 0 0 0 1
1 3 0 4 1 1 1 1
1 1 1 1 1 5 5 5