7 5
1 1 1 1 1 5 5
1 4 0 0 1 5 5
1 0 1 2 1 1 1
1 0 2 0 3 3 1
1 1 1 1 1 1 1